spec,test,#-NOT_RUN,#-FIRST_DELAYED,#-BEFORE_SECOND,#-SECOND_EXECUTED,#-COMPLETE,total,is_second_not_run
00001,all-tests,0,4,0,0,0,4,0
00001,DecoderExceptionTest,0,4,0,0,0,4,0
00002,all-tests,0,4,0,0,0,4,0
00002,EncoderExceptionTest,0,4,0,0,0,4,0
00014,Base16Test#testKnownDecodings,5,1,0,0,0,6,1
00017,Base16Test#testKnownDecodings,5,1,0,0,0,6,1
00019,Base16Test#testKnownDecodings,5,1,0,0,0,6,1
00020,Base16Test#testKnownDecodings,5,1,0,0,0,6,1
00023,Base16Test#testTriplets,15,1,0,0,0,16,1
00023,Base16Test#testKnownEncodings,5,1,0,0,0,6,1
00024,Base16Test#testTriplets,15,1,0,0,0,16,1
00024,Base16Test#testKnownEncodings,5,1,0,0,0,6,1
00025,Base16Test#testSingletons,105,1,0,0,0,106,1
00025,Base16Test#testPairs,18,1,0,0,0,19,1
00025,Base16Test#testTriplets,15,1,0,0,0,16,1
00025,Base16Test#testKnownEncodings,5,1,0,0,0,6,1
00026,Base16Test#testTriplets,15,1,0,0,0,16,1
00026,Base16Test#testKnownEncodings,5,1,0,0,0,6,1
00027,Base16Test#testTriplets,15,1,0,0,0,16,1
00027,Base16Test#testKnownEncodings,5,1,0,0,0,6,1
00036,Base16Test#testSingletons,1,1,0,0,0,2,1
00036,Base16Test#testPairs,1,1,0,0,0,2,1
00036,Base16Test#testEncodeDecodeSmall,1,1,0,0,0,2,1
00036,Base16Test#testEncodeDecodeRandom,1,1,0,0,0,2,1
00036,Base16Test#testObjectDecodeWithValidParameter,1,1,0,0,0,2,1
00036,Base16Test#testObjectEncodeWithValidParameter,1,1,0,0,0,2,1
00036,Base16Test#testBase16,1,1,0,0,0,2,1
00037,Base16Test#testSingletons,1,1,0,0,0,2,1
00037,Base16Test#testPairs,1,1,0,0,0,2,1
00037,Base16Test#testEncodeDecodeSmall,1,1,0,0,0,2,1
00037,Base16Test#testEncodeDecodeRandom,1,1,0,0,0,2,1
00037,Base16Test#testObjectDecodeWithValidParameter,1,1,0,0,0,2,1
00037,Base16Test#testObjectEncodeWithValidParameter,1,1,0,0,0,2,1
00037,Base16Test#testBase16,1,1,0,0,0,2,1
00038,Base16Test#testSingletons,1,1,0,0,0,2,1
00038,Base16Test#testPairs,1,1,0,0,0,2,1
00038,Base16Test#testEncodeDecodeSmall,1,1,0,0,0,2,1
00038,Base16Test#testEncodeDecodeRandom,1,1,0,0,0,2,1
00038,Base16Test#testObjectDecodeWithValidParameter,1,1,0,0,0,2,1
00038,Base16Test#testObjectEncodeWithValidParameter,1,1,0,0,0,2,1
00038,Base16Test#testBase16,1,1,0,0,0,2,1
00041,Base16Test,0,2,0,0,0,2,0
00041,all-tests,0,2,0,0,0,2,0
00042,Base16Test,0,2,0,0,0,2,0
00042,all-tests,0,2,0,0,0,2,0
00078,Base32Test#testBase32DecodingOfTrailing30Bits,0,0,0,0,2,2,0
00078,Base32Test#testBase32DecodingOfTrailing20Bits,0,0,0,0,2,2,0
00078,Base32Test#testBase32DecodingOfTrailing5Bits,0,0,0,0,2,2,0
00078,Base32Test#testBase32DecodingOfTrailing25Bits,0,0,0,0,2,2,0
00078,Base32Test#testBase32DecodingOfTrailing15Bits,0,0,0,0,2,2,0
00078,Base32Test#testBase32DecodingOfTrailing10Bits,0,0,0,0,2,2,0
00078,Base32Test#testBase32DecodingOfTrailing35Bits,0,0,0,0,2,2,0
00081,Base32InputStreamTest#testStrictDecoding,0,0,0,0,4,4,0
00081,Base32OutputStreamTest#testStrictDecoding,0,0,0,0,4,4,0
00089,Base32InputStreamTest#testStrictDecoding,0,4,0,0,0,4,0
00089,Base32OutputStreamTest#testBase32OutputStreamByChunk,0,4,0,0,0,4,0
00089,Base32OutputStreamTest#testBase32OutputStreamByteByByte,0,4,0,0,0,4,0
00089,Base32InputStreamTest#testBase32InputStreamByChunk,0,4,0,0,0,4,0
00089,Base32InputStreamTest,0,4,0,0,0,4,0
00089,Base32InputStreamTest#testBase32InputStreamByteByByte,0,4,0,0,0,4,0
00089,Base32OutputStreamTest#testStrictDecoding,0,4,0,0,0,4,0
00089,Base32OutputStreamTest,0,4,0,0,0,4,0
00104,Base32OutputStreamTest#testStrictDecoding,0,1,0,0,1,2,0
00104,Base32OutputStreamTest,0,1,0,0,1,2,0
00116,BCodecTest#testBase64ImpossibleSamplesDefault,0,0,0,0,2,2,0
00116,BCodecTest#testBase64ImpossibleSamplesLenient,0,0,0,0,2,2,0
00116,BCodecTest#testBase64ImpossibleSamplesStrict,0,0,2,0,0,2,0
00121,BCodecTest#testUTF8RoundTrip,0,0,0,0,2,2,0
00121,BCodecTest#testBasicEncodeDecode,0,0,0,0,2,2,0
00123,BCodecTest#testBase64ImpossibleSamplesDefault,0,2,0,0,0,2,0
00123,BCodecTest#testBase64ImpossibleSamplesLenient,0,2,0,0,0,2,0
00123,BCodecTest#testBase64ImpossibleSamplesStrict,1,1,0,0,0,2,1
00139,BCodecTest#testBase64ImpossibleSamplesDefault,0,2,0,0,0,2,0
00139,BCodecTest#testBase64ImpossibleSamplesLenient,0,2,0,0,0,2,0
00139,Base64Codec13Test#testStaticDecodeChunked,0,2,0,0,0,2,0
00139,BCodecTest,0,2,0,0,0,2,0
00139,BCodecTest#testBase64ImpossibleSamplesStrict,1,1,0,0,0,2,1
00139,Base64Codec13Test#testStaticDecode,0,2,0,0,0,2,0
00140,BCodecTest#testBase64ImpossibleSamplesDefault,0,0,0,0,2,2,0
00140,BCodecTest#testBase64ImpossibleSamplesLenient,0,0,0,0,2,2,0
00141,BCodecTest#testBase64ImpossibleSamplesDefault,0,0,0,0,2,2,0
00141,BCodecTest#testBase64ImpossibleSamplesLenient,0,0,0,0,2,2,0
00145,BCodecTest#testBase64ImpossibleSamplesStrict,1,0,0,0,1,2,1
00160,Base32InputStreamTest#testStrictDecoding,0,0,0,0,4,4,0
00160,Base32OutputStreamTest#testStrictDecoding,0,0,0,0,4,4,0
00162,BCodecTest#testBase64ImpossibleSamplesDefault,0,0,0,0,2,2,0
00162,BCodecTest#testBase64ImpossibleSamplesLenient,0,0,0,0,2,2,0
00162,BCodecTest#testBase64ImpossibleSamplesStrict,0,0,2,0,0,2,0
00164,Base16Test#testSingletons,0,0,0,0,2,2,0
00164,Base16Test#testPairs,0,0,0,0,2,2,0
00164,Base16Test#testEncodeDecodeSmall,0,0,0,0,2,2,0
00164,BCodecTest#testUTF8RoundTrip,0,0,0,0,2,2,0
00164,Base16Test#testEncodeDecodeRandom,0,0,0,0,2,2,0
00164,Base16Test#testObjectDecodeWithValidParameter,0,0,0,0,2,2,0
00164,Base16Test#testObjectEncodeWithValidParameter,0,0,0,0,2,2,0
00164,Base16Test#testBase16,0,0,0,0,2,2,0
00164,BCodecTest#testBasicEncodeDecode,0,0,0,0,2,2,0
00166,Base32InputStreamTest#testStrictDecoding,0,0,0,0,4,4,0
00166,Base32OutputStreamTest#testStrictDecoding,0,0,0,0,4,4,0
00168,Base16Test#testEncodeDecodeSmall,1,1,0,0,0,2,1
00168,Base16Test#testEncodeDecodeRandom,1,1,0,0,0,2,1
00168,Base16Test#testObjectDecodeWithValidParameter,1,1,0,0,0,2,1
00168,Base16Test#testObjectEncodeWithValidParameter,1,1,0,0,0,2,1
00195,all-tests,0,2,0,0,0,2,0
00195,DigestUtilsTest,0,2,0,0,0,2,0
00202,all-tests,0,2,0,0,0,2,0
00202,DigestUtilsTest,0,2,0,0,0,2,0
00207,all-tests,1,1,0,0,0,2,1
00207,DigestUtilsTest#testSha224_StringAsHex,1,1,0,0,0,2,1
00207,DigestUtilsTest,1,1,0,0,0,2,1
00208,all-tests,0,2,0,0,0,2,0
00208,DigestUtilsTest,0,2,0,0,0,2,0
00211,all-tests,0,2,0,0,0,2,0
00211,DigestUtilsTest,0,2,0,0,0,2,0
00217,DoubleMetaphoneTest#testNTilde,0,2,0,0,0,2,0
00217,DoubleMetaphoneTest#testCCedilla,0,2,0,0,0,2,0
00218,DoubleMetaphoneTest#testNTilde,0,2,0,0,0,2,0
00218,DoubleMetaphoneTest#testCCedilla,0,2,0,0,0,2,0
00219,DoubleMetaphoneTest#testNTilde,0,0,0,0,2,2,0
00219,DoubleMetaphoneTest#testCCedilla,0,0,0,0,2,2,0
00227,DoubleMetaphoneTest#testIsDoubleMetaphoneEqualExtended3,0,0,0,0,2,2,0
00227,DoubleMetaphoneTest,0,0,0,0,2,2,0
00227,DoubleMetaphoneTest#testIsDoubleMetaphoneEqualWithMATCHES,0,0,0,0,2,2,0
00282,PhoneticEngineRegressionTest#testCompatibilityWithOriginalVersion,1,1,0,0,0,2,1
00282,BeiderMorseEncoderTest#testLongestEnglishSurname,1,1,0,0,0,2,1
00282,BeiderMorseEncoderTest#testOOM,1,1,0,0,0,2,1
00282,BeiderMorseEncoderTest#testAsciiEncodeNotEmpty1Letter,0,2,0,0,0,2,0
00282,BeiderMorseEncoderTest#testEncodeAtzNotEmpty,1,1,0,0,0,2,1
00282,BeiderMorseEncoderTest#testEncodeGna,1,1,0,0,0,2,1
00282,BeiderMorseEncoderTest#testLocaleIndependence,0,2,0,0,0,2,0
00282,PhoneticEngineRegressionTest#testSolrSEPHARDIC,1,1,0,0,0,2,1
00282,PhoneticEngineRegressionTest,0,2,0,0,0,2,0
00282,BeiderMorseEncoderTest#testSpeedCheck2,0,2,0,0,0,2,0
00282,PhoneticEngineTest,1,1,0,0,0,2,1
00282,BeiderMorseEncoderTest#testAsciiEncodeNotEmpty2Letters,1,1,0,0,0,2,1
00282,PhoneticEngineRegressionTest#testSolrGENERIC,1,1,0,0,0,2,1
00282,BeiderMorseEncoderTest#testSpeedCheck,0,2,0,0,0,2,0
00282,PhoneticEngineRegressionTest#testSolrASHKENAZI,1,1,0,0,0,2,1
00283,PhoneticEngineRegressionTest#testCompatibilityWithOriginalVersion,1,1,0,0,0,2,1
00283,BeiderMorseEncoderTest#testLongestEnglishSurname,1,1,0,0,0,2,1
00283,BeiderMorseEncoderTest#testOOM,1,1,0,0,0,2,1
00283,BeiderMorseEncoderTest#testAsciiEncodeNotEmpty1Letter,1,1,0,0,0,2,1
00283,BeiderMorseEncoderTest#testEncodeAtzNotEmpty,1,1,0,0,0,2,1
00283,BeiderMorseEncoderTest#testEncodeGna,1,1,0,0,0,2,1
00283,BeiderMorseEncoderTest#testLocaleIndependence,1,1,0,0,0,2,1
00283,PhoneticEngineRegressionTest#testSolrSEPHARDIC,1,1,0,0,0,2,1
00283,PhoneticEngineRegressionTest,0,2,0,0,0,2,0
00283,BeiderMorseEncoderTest#testSpeedCheck2,1,1,0,0,0,2,1
00283,PhoneticEngineTest,1,1,0,0,0,2,1
00283,BeiderMorseEncoderTest#testAsciiEncodeNotEmpty2Letters,1,1,0,0,0,2,1
00283,PhoneticEngineRegressionTest#testSolrGENERIC,1,1,0,0,0,2,1
00283,BeiderMorseEncoderTest#testSpeedCheck,1,1,0,0,0,2,1
00283,PhoneticEngineRegressionTest#testSolrASHKENAZI,1,1,0,0,0,2,1
00290,BeiderMorseEncoderTest#testLongestEnglishSurname,0,0,0,0,2,2,0
00290,BeiderMorseEncoderTest#testSpeedCheck3,0,0,0,0,2,2,0
00290,BeiderMorseEncoderTest#testAsciiEncodeNotEmpty1Letter,0,0,0,0,2,2,0
00290,BeiderMorseEncoderTest#testEncodeAtzNotEmpty,0,0,0,0,2,2,0
00290,BeiderMorseEncoderTest#testEncodeGna,0,0,0,0,2,2,0
00290,BeiderMorseEncoderTest#testSpeedCheck2,0,0,0,0,2,2,0
00290,BeiderMorseEncoderTest#testAsciiEncodeNotEmpty2Letters,0,0,0,0,2,2,0
00290,BeiderMorseEncoderTest#testAllChars,0,0,0,0,2,2,0
00290,BeiderMorseEncoderTest#testSpeedCheck,0,0,0,0,2,2,0
